######i|i#######
-..............#
-..^.....c.....x
-..............#
#######.########
-..............p
^..............c
####+++x+++###-#
